Aaron Krickstein=Krickstein
Adrian Voinea=Voinea
Adriano Panatta=Panatta
Ágnes Szávay=Szávay
Agnieszka Radwańska=Radwańska
Ai Sugiyama=Sugiyama
Albert Costa=Costa
Albert Ramos-Viñolas=Ramos-Viñolas
Alberto Berasategui=Berasategui
Alberto Mancini=Mancini
Àlex Corretja=Corretja
Alex Metreveli=Metreveli
Alex Rădulescu=Rădulescu
Alexander Popp=Popp
Alexander Volkov=Volkov
Alexandra Stevenson=Stevenson
Alison Van Uytvanck=Uytvanck
Amanda Coetzer=Coetzer
Amélie Mauresmo=Mauresmo
Amy Frazier=Frazier
Ana Ivanovic=Ivanovic
Ana Konjuh=Konjuh
Anastasia Myskina=Myskina
Anastasija Sevastova=Sevastova
Anders Järryd=Järryd
Andre Agassi=Agassi
André Sá=Sá
Andrea Jaeger=Jaeger
Andrea Petkovic=Petkovic
Andrei Cherkasov=Cherkasov
Andrei Chesnokov=Chesnokov
Andrei Medvedev=Medvedev
Andrei Pavel=Pavel
Andrés Gimeno=Gimeno
Andrés Gómez=Gómez
Andrew Pattison=Pattison
Andrey Rublev=Rublev
Andriy Medvedev=Medvedev
Andy Murray=Murray
Andy Roddick=Roddick
Angelique Kerber=Kerber
Anke Huber=Huber
Ann Haydon-Jones=Haydon-Jones
Ann Jones=Jones
Anna Chakvetadze=Chakvetadze
Anna Kournikova=Kournikova
Anna-Lena Grönefeld=Grönefeld
Anne Smith=Smith
Annette Van Zyl=Van Zyl
Arantxa Sánchez=Sánchez
Arnaud Clément=Clément
Arthur Ashe=Ashe
Balázs Taróczy=Taróczy
Barbara Gerken=Gerken
Barbara Hallquist=Hallquist
Barbara Potter=Potter
Barbara Schett=Schett
Barbara Schwartz=Schwartz
Barbora Strýcová=Strýcová
Belinda Bencic=Bencic
Bernard Tomic=Tomic
Bernd Karbacher=Karbacher
Bettina Bunge=Bunge
Bettina Fulco=Fulco
Betty Stöve=Stöve
Bill Scanlon=Scanlon
Billie Jean King=King
Billy Martin=Martin
Björn Borg=Borg
Bob Carmichael=Carmichael
Bonnie Gadusek=Gadusek
Boris Becker=Becker
Boro Jovanović=Jovanović
Brad Gilbert=Gilbert
Brad Pearce=Pearce
Brian Fairlie=Fairlie
Brian Gottfried=Gottfried
Brian Teacher=Teacher
Brigitte Simon=Simon
Bruce Manson=Manson
Butch Buchholz=Buchholz
Butch Walts=Walts
Byron Bertram=Bertram
Byron Black=Black
Camille Benjamin=Benjamin
Carina Karlsson=Karlsson
Carla Suárez Navarro=Suárez
Carling Bassett=Bassett
Carlos Moyà=Moyà
Caroline Garcia=Garcia
Caroline Wozniacki=Wozniacki
Catarina Lindqvist=Lindqvist
Cédric Pioline=Pioline
Chanda Rubin=Rubin
Charlie Pasarell=Pasarell
Chris Evert=Evert
Chris Lewis=Lewis
Christian Bergström=Bergström
Cici Martinez=Martinez
Clarisa Fernández=Fernández
Clark Graebner=Graebner
Claudia Kohde-Kilsch=Kohde-Kilsch
Cliff Drysdale=Drysdale
Cliff Richey=Richey
CoCo Vandeweghe=Vandeweghe
Colin Dibley=Dibley
Conchita Martínez=Martínez
Corinne Molesworth=Molesworth
Corrado Barazzutti=Barazzutti
Dája Bedáňová=Bedáňová
Dan Goldie=Goldie
Daniela Hantuchová=Hantuchová
Darren Cahill=Cahill
David Ferrer=Ferrer
David Goffin=Goffin
David Nalbandian=Nalbandian
David Wheaton=Wheaton
Davide Sanguinetti=Sanguinetti
Denisa Chládková=Chládková
Dennis Ralston=Ralston
Derrick Rostagno=Rostagno
Dianne Fromholtz=Fromholtz
Dick Stockton=Stockton
Diego Schwartzman=Schwartzman
Dinara Safina=Safina
Dominic Thiem=Thiem
Dominik Hrbatý=Hrbatý
Dominika Cibulková=Cibulková
Donna Ganz=Ganz
Earl Butch Buchholz=Buchholz
Eddie Dibbs=Dibbs
Ekaterina Makarova=Makarova
Elena Bovina=Bovina
Elena Dementieva=Dementieva
Elena Likhovtseva=Likhovtseva
Elena Subirats=Subirats
Elena Vesnina=Vesnina
Elina Svitolina=Svitolina
Eliot Teltscher=Teltscher
Emilio Sánchez=Sánchez
Ernests Gulbis=Gulbis
Eugenie Bouchard=Bouchard
Éva Szabó=Szabó
Evonne Cawley=Cawley
Evonne Goolagong=Goolagong
Fabio Fognini=Fognini
Feliciano López=López
Félix Mantilla Botella=Mantilla
Fernando González=González
Fernando Meligeni=Meligeni
Fernando Verdasco=Verdasco
Filip Dewulf=Dewulf
Fiorella Bonicelli=Bonicelli
Flavia Pennetta=Pennetta
Florența Mihai=Mihai
Florian Mayer=Mayer
Francesca Schiavone=Schiavone
Franco Davín=Davín
Franco Squillari=Squillari
François Jauffret=Jauffret
Françoise Dürr=Dürr
Frank Froehling=Froehling
Fred Stolle=Stolle
Frew McMillan=McMillan
Gabriela Sabatini=Sabatini
Gaël Monfils=Monfils
Gail Chanfreau=Chanfreau
Galo Blanco=Blanco
Garbiñe Muguruza=Muguruza
Gastón Gaudio=Gaudio
Gene Mayer=Mayer
Georges Goven=Goven
Gigi Fernández=Fernández
Gilles Müller=Müller
Gilles Simon=Simon
Goran Ivanišević=Ivanišević
Goran Prpić=Prpić
Greer Stevens=Stevens
Greg Rusedski=Rusedski
Gretchen Rush=Rush
Grigor Dimitrov=Dimitrov
Guillermo Cañas=Cañas
Guillermo Coria=Coria
Guillermo Pérez Roldán=Pérez Roldán
Guillermo Vilas=Vilas
Gustavo Kuerten=Kuerten
Guy Forget=Forget
Hana Mandlíková=Mandlíková
Hans Gildemeister=Gildemeister
Harold Solomon=Solomon
Heinz Günthardt=Günthardt
Helen Gourlay=Gourlay
Helen Kelesi=Kelesi
Helena Suková=Suková
Helga Masthoff=Masthoff
Helga Niessen=Niessen
Hendrik Dreekmann=Dreekmann
Henri Leconte=Leconte
Henrik Sundström=Sundström
Hicham Arazi=Arazi
Igor Andreev=Andreev
Ilie Năstase=Năstase
Inés Gorrochategui=Gorrochategui
Ion Țiriac=Țiriac
Irina Spîrlea=Spîrlea
Ismail El Shafei=Shafei
István Gulyás=Gulyás
Iva Majoli=Majoli
Ivan Lendl=Lendl
Ivan Ljubičić=Ljubičić
Ivanna Madruga=Madruga
Ivo Karlović=Karlović
Jacco Eltingh=Eltingh
Jaime Fillol=Fillol
Jaime Yzaga=Yzaga
Jakob Hlasek=Hlasek
James Blake=Blake
Jan Kodeš=Kodeš
Jan Siemerink=Siemerink
Jana Novotná=Novotná
Janet Newberry=Newberry
Janko Tipsarević=Tipsarević
Jan-Michael Gambill=Gambill
Jarkko Nieminen=Nieminen
Jason Stoltenberg=Stoltenberg
Javier Sánchez=Sánchez
Jay Berger=Berger
Jelena Dokic=Dokic
Jelena Dokić=Dokić
Jelena Janković=Janković
Jeļena Ostapenko=Ostapenko
Jennifer Capriati=Capriati
Jennifer Mundel=Mundel
Jerzy Janowicz=Janowicz
Jim Courier=Courier
Jimmy Arias=Arias
Jimmy Connors=Connors
Jo Durie=Durie
Joachim Johansson=Johansson
Joakim Nyström=Nyström
JoAnne Russell=Russell
Johan Kriek=Kriek
Johanna Konta=Konta
John Andrews=Andrews
John Isner=Isner
John Lloyd=Lloyd
John McEnroe=McEnroe
John Newcombe=Newcombe
John Sadri=Sadri
Jonas Björkman=Björkman
Jonas Svensson=Svensson
José Higueras=Higueras
José Luis Clerc=Clerc
Jo-Wilfried Tsonga=Tsonga
Joyce Williams=Williams
Juan Carlos Ferrero=Ferrero
Juan Ignacio Chela=Chela
Juan Martín del Potro=del Potro
Judith Wiesner=Wiesner
Judy Tegart=Tegart
Julie Halard=Halard
Julie Heldman=Heldman
Julien Benneteau=Benneteau
Jürgen Fassbender=Fassbender
Jürgen Melzer=Melzer
Justine Henin=Henin
Kaia Kanepi=Kanepi
Karel Nováček=Nováček
Karen Krantzcke=Krantzcke
Karina Habšudová=Habšudová
Karol Kučera=Kučera
Karolína Plíšková=Plíšková
Karolina Šprem=Šprem
Katerina Maleeva=Maleeva
Kateryna Bondarenko=Bondarenko
Kathy Horvath=Horvath
Kathy Jordan=Jordan
Kathy Kuykendall=Kuykendall
Kathy May=May
Kathy Rinaldi=Rinaldi
Katja Ebbinghaus=Ebbinghaus
Kazuko Sawamatsu=Sawamatsu
Kei Nishikori=Nishikori
Ken Rosewall=Rosewall
Kerry Reid=Reid
Kevin Anderson=Anderson
Kevin Curren=Curren
Kiki Bertens=Bertens
Kim Clijsters=Clijsters
Kim Warwick=Warwick
Kimiko Date=Date
Kirsten Flipkens=Flipkens
Kristina Mladenovic=Mladenovic
Larisa Neiland=Neiland
Larisa Savchenko=Savchenko
Laura Arraya=Arraya
Laura duPont=Laura duPont
Laura Golarsa=Golarsa
Leila Meskhi=Meskhi
Lesley Bowrey=Bowrey
Lesley Hunt=Hunt
Lesley Turner Bowrey=Bowrey
Li Na=Li
Linda Tuero=Tuero
Linda Wild=Wild
Lindsay Davenport=Davenport
Linky Boshoff=Boshoff
Lisa Bonder=Bonder
Lisa Raymond=Raymond
Lleyton Hewitt=Hewitt
Lori McNeil=McNeil
Lu Yen-hsun=Lu
Lucas Pouille=Pouille
Lucia Romanov=Romanov
Lucie Šafářová=Šafářová
Łukasz Kubot=Kubot
Madison Keys=Keys
Magdalena Maleeva=Maleeva
Magnus Larsson=Larsson
Magnus Norman=Norman
Magüi Serna=Serna
MaliVai Washington=Washington
Manon Bollegraf=Bollegraf
Manuel Orantes=Orantes
Manuela Maleeva=Maleeva
Marat Safin=Safin
Marc Rosset=Rosset
Marcelo Filippini=Filippini
Marcelo Ríos=Ríos
Marcos Baghdatis=Baghdatis
Mardy Fish=Fish
Margaret Court=Court
Maria Bueno=Bueno
Maria Kirilenko=Kirilenko
Maria Sharapova=Sharapova
Mariano Puerta=Puerta
Mariano Zabaleta=Zabaleta
Marie Pinterova=Pinterova
Marijke Schaar=Schaar
Marin Čilić=Čilić
Mario Ančić=Ančić
Marion Bartoli=Bartoli
Marise Kruger=Kruger
Mark Dickson=Dickson
Mark Edmondson=Edmondson
Mark Philippoussis=Philippoussis
Marta Marrero=Marrero
Martín Jaite=Jaite
Martin Mulligan=Mulligan
Martin Verkerk=Verkerk
Martina Hingis=Hingis
Martina Navratilova=Navratilova
Marty Riessen=Riessen
Mary Joe Fernández=Fernández
Mary Pierce=Pierce
Maryna Godwin=Godwin
Mats Wilander=Wilander
Max Mirnyi=Mirnyi
Mel Purcell=Purcell
Melanie Oudin=Oudin
Melissa Brown=Brown
Meredith McGrath=McGrath
Michael Chang=Chang
Michael Stich=Stich
Michaëlla Krajicek=Krajicek
Mikael Pernfors=Pernfors
Mikhail Youzhny=Youzhny
Milan Šrejber=Šrejber
Milos Raonic=Raonic
Miloslav Mečíř=Mečíř
Mima Jaušovec=Jaušovec
Mirjana Lučić-Baroni=Lučić-Baroni
Miroslava Bendlova=Bendlova
Miroslava Holubova=Holubova
Molly Van Nostrand=Van Nostrand
Monica Seles=Seles
Nadia Petrova=Petrova
Nancy Richey=Richey
Nancy Richey Gunter=Gunter
Natasha Chmyreva=Chmyreva
Natasha Zvereva=Zvereva
Nathalie Tauziat=Tauziat
Nick Kyrgios=Kyrgios
Nicklas Kulti=Kulti
Nicolás Almagro=Almagro
Nicolas Escudé=Escudé
Nicolas Kiefer=Kiefer
Nicolás Lapentti=Lapentti
Nicole Provis=Provis
Nicole Vaidišová=Vaidišová
Nikola Pilić=Pilić
Nikolay Davydenko=Davydenko
Novak Djokovic=Djokovic
Odile de Roubin=de Roubin
Olga Morozova=Morozova
Onny Parun=Parun
Pablo Carreño Busta=Carreño Busta
Pam Shriver=Shriver
Pam Teeguarden=Teeguarden
Pancho Gonzales=Gonzales
Paola Suárez=Suárez
Paolo Bertolucci=Bertolucci
Pascale Paradis=Paradis
Pat Cash=Cash
Pat Dupre=Dupre
Pat DuPré=DuPré
Pat Rafter=Rafter
Patricia Hy=Hy
Patricio Cornejo=Cornejo
Patrick McEnroe=McEnroe
Patrick Proisy=Proisy
Patrick Rafter=Rafter
Patrik Kühnen=Kühnen
Patti Hogan=Hogan
Patty Schnyder=Schnyder
Paul Annacone=Annacone
Paul Chamberlin=Chamberlin
Paul Haarhuis=Haarhuis
Peaches Bartkowicz=Bartkowicz
Peng Shuai=Shuai
Pete Sampras=Sampras
Peter Fleming=Fleming
Peter McNamara=McNamara
Petr Korda=Korda
Petra Kvitová=Kvitová
Petra Mandula=Mandula
Petra Ritter=Ritter
Phil Dent=Dent
Philipp Kohlschreiber=Kohlschreiber
Radek Štěpánek=Štěpánek
Rafael Nadal=Nadal
Raffaella Reggi=Reggi
Rainer Schüttler=Schüttler
Ramesh Krishnan=Krishnan
Raquel Giscafré=Giscafré
Raúl Ramírez=Ramírez
Raymond Moore=Moore
Regina Maršíková=Maršíková
Renáta Tomanová=Tomanová
Renzo Furlan=Furlan
Ricardo Acuña=Acuña
Richard Gasquet=Gasquet
Richard Krajicek=Krajicek
Robby Ginepri=Ginepri
Robert Lutz=Lutz
Roberta Vinci=Vinci
Robin Söderling=Söderling
Rod Frawley=Frawley
Rod Laver=Laver
Rodney Harmon=Harmon
Roger Federer=Federer
Roger Taylor=Taylor
Ronald Agénor=Agénor
Rosalyn Fairbank=Fairbank
Roscoe Tanner=Tanner
Rosemary Casals=Casals
Roy Emerson=Emerson
Ruta Gerulaitis=Gerulaitis
Ruxandra Dragomir=Dragomir
Sabine Hack=Hack
Sabine Lisicki=Lisicki
Sam Querrey=Querrey
Samantha Stosur=Stosur
Sandra Cecchini=Cecchini
Sandrine Testud=Testud
Sandy Mayer=Mayer
Sara Errani=Errani
Sébastien Grosjean=Grosjean
Serena Williams=Williams
Sergi Bruguera=Bruguera
Sesil Karatantcheva=Karatantcheva
Séverine Beltrame=Beltrame
Shahar Pe’er=Shahar Pe’er
Shelby Rogers=Rogers
Shinobu Asagoe=Asagoe
Shuzo Matsuoka=Matsuoka
Silvia Farina Elia=Elia
Simona Halep=Halep
Sjeng Schalken=Schalken
Slava Doseděl=Doseděl
Sloane Stephens=Stephens
Slobodan Živojinović=Živojinović
Sorana Cîrstea=Cîrstea
Stan Smith=Smith
Stan Wawrinka=Wawrinka
Stanislas Wawrinka=Wawrinka
Stefan Edberg=Edberg
Steffi Graf=Graf
Sue Barker=Barker
Svetlana Kuznetsova=Kuznetsova
Sybille Bammer=Bammer
Sylvia Hanika=Hanika
Sylvia Plischke=Plischke
Tamarine Tanasugarn=Tanasugarn
Tamira Paszek=Paszek
Tatiana Golovin=Golovin
Terry Phelps=Phelps
Thierry Champion=Champion
Thomas Enqvist=Enqvist
Thomas Johansson=Johansson
Thomas Muster=Muster
Thomaz Koch=Koch
Tim Gullikson=Gullikson
Tim Henman=Henman
Tim Mayotte=Mayotte
Tim Wilkison=Wilkison
Timea Bacsinszky=Bacsinszky
Todd Martin=Martin
Todd Woodbridge=Woodbridge
Tom Gorman=Gorman
Tom Gullikson=Gullikson
Tom Okker=Okker
Tomáš Berdych=Berdych
Tomáš Šmíd=Šmíd
Tommy Haas=Haas
Tommy Robredo=Robredo
Tony Roche=Roche
Tracy Austin=Austin
Tsvetana Pironkova=Pironkova
Vasek Pospisil=Pospisil
Venus Williams=Williams
Vera Zvonareva=Zvonareva
Victor Hănescu=Hănescu
Víctor Pecci=Pecci
Victoria Azarenka=Azarenka
Vijay Amritraj=Amritraj
Virginia Ruano Pascual=Ruano Pascual
Virginia Ruzici=Ruzici
Virginia Wade=Wade
Vitas Gerulaitis=Gerulaitis
Vladimir Voltchkov=Voltchkov
Vlasta Vopičková=Vopičková
Wally Masur=Masur
Wayne Ferreira=Ferreira
Wendy Turnbull=Turnbull
Winnie Shaw=Shaw
Wojciech Fibak=Fibak
Xavier Malisse=Malisse
Yanina Wickmayer=Wickmayer
Yannick Noah=Noah
Yaroslava Shvedova=Shvedova
Yayuk Basuki=Basuki
Yevgeny Kafelnikov=Kafelnikov
Younes El Aynaoui=El Aynaoui
Yulia Putintseva=Putintseva
Yvonne Vermaak=Vermaak
Željko Franulović=Franulović
Zenda Liess=Liess
Zheng Jie=Zheng
Zina Garrison=Garrison